XXXXXXXXXXXXXXX
X.....X.......X
X.X.X.X.XXXXX.X
X.X.X.@.X...X.X
X.X.XXXXX.X.X.X
X.X.......X.X.X
X.XXXXXXXXX.X.X
E.............X
XXXXXXXXXXXXXXX
