XXXXXXXXXXXXXXXXXXXXXXXXX
E......X.....X.......X..X
X.XXX.X.XXX.X.XXX.X.X.X.X
X.X...X...X...X...X.X.X.X
X.X.XXXXX.XXXXX.XXX.X.X.X
X.X.......X.....X...X.X.X
X.XXXXXXX.X.XXX.XXX.X.X.X
X.......X.X.X...X...X.X.X
XXXXX.X.X.X.X.XXX.XXX.X.X
X.....X.X.X.X...X...X.X.X
X.XXX.X.X.X.XXX.X.XXX.X.X
X.X...X.X.X...X.X...X.X.X
X.X.XXX.X.XXX.X.X.XXX.X.X
X.X.....X...X.X.X...X.X.X
X.XXXXXXX.XXX.X.XXX.X.X.X
X.......X.....X...X.X.X.X
X.XXXXX.XXXXXXXXX.X.X.X.X
X...X...X.......X.X.X.X.X
XXX.X.XXX.XXXXX.X.X.X.X.X
X...X.....X...X.X.X.X.@.X
X.XXXXXXXXX.X.X.X.X.XXX.X
X...........X.X.X.X.....X
X.XXXXXXXXXXX.X.X.XXXXXXX
X............X..........X
XXXXXXXXXXXXXXXXXXXXXXXXX
